static const addSvg = 'assets/svg/add.svg';
static const arrowRightSvg = 'assets/svg/arrow-right.svg';
static const bookSvg = 'assets/svg/book.svg';
static const bookingSvg = 'assets/svg/booking.svg';
static const carSvg = 'assets/svg/car.svg';
static const cartSvg = 'assets/svg/cart.svg';
static const cart2Svg = 'assets/svg/cart2.svg';
static const catalogSvg = 'assets/svg/catalog.svg';
static const circleBlueIslandSvg = 'assets/svg/circle-blue-island.svg';
static const circleCheckBlackSvg = 'assets/svg/circle-check-black.svg';
static const circleCheckFilledSvg = 'assets/svg/circle-check-filled.svg';
static const circleCheckSvg = 'assets/svg/circle-check.svg';
static const circleClockSvg = 'assets/svg/circle-clock.svg';
static const circleFinanceSvg = 'assets/svg/circle-finance.svg';
static const circleMinusSvg = 'assets/svg/circle-minus.svg';
static const circlePlusSvg = 'assets/svg/circle-plus.svg';
static const circleRmbSvg = 'assets/svg/circle-rmb.svg';
static const circleStoreSvg = 'assets/svg/circle-store.svg';
static const circleWhiteIslandSvg = 'assets/svg/circle-white-island.svg';
static const circleSvg = 'assets/svg/circle.svg';
static const clockSvg = 'assets/svg/clock.svg';
static const cloneSvg = 'assets/svg/clone.svg';
static const coffeeMinSvg = 'assets/svg/coffee-min.svg';
static const coffeeSvg = 'assets/svg/coffee.svg';
static const commentSvg = 'assets/svg/comment.svg';
static const communitySvg = 'assets/svg/community.svg';
static const consulSvg = 'assets/svg/consul.svg';
static const consulateSvg = 'assets/svg/consulate.svg';
static const copySvg = 'assets/svg/copy.svg';
static const cultureSelectedSvg = 'assets/svg/culture-selected.svg';
static const cultureSvg = 'assets/svg/culture.svg';
static const dashboardSvg = 'assets/svg/dashboard.svg';
static const destinationSvg = 'assets/svg/destination.svg';
static const doubleArrowLeftSvg = 'assets/svg/double-arrow-left.svg';
static const doubleArrowRightSvg = 'assets/svg/double-arrow-right.svg';
static const editSvg = 'assets/svg/edit.svg';
static const errorWarningSvg = 'assets/svg/error-warning.svg';
static const erweimaSvg = 'assets/svg/erweima.svg';
static const fileTextSvg = 'assets/svg/file-text.svg';
static const filterSvg = 'assets/svg/filter.svg';
static const followSvg = 'assets/svg/follow.svg';
static const greaterThenShallowSvg = 'assets/svg/greater-then-shallow.svg';
static const greaterThenSvg = 'assets/svg/greater-then.svg';
static const greyIslandSvg = 'assets/svg/grey-island.svg';
static const inboxMinSvg = 'assets/svg/inbox-min.svg';
static const insuranceCarsSvg = 'assets/svg/insurance-cars.svg';
static const insurancePeopleSvg = 'assets/svg/insurance-people.svg';
static const insuranceSvg = 'assets/svg/insurance.svg';
static const invoiceSvg = 'assets/svg/invoice.svg';
static const islandCoffeeBagSvg = 'assets/svg/island-coffee-bag.svg';
static const islandCoffeeCupSvg = 'assets/svg/island-coffee-cup.svg';
static const islandCoffeeCup2Svg = 'assets/svg/island-coffee-cup2.svg';
static const islandFishingSvg = 'assets/svg/island-fishing.svg';
static const islandMinSvg = 'assets/svg/island-min.svg';
static const islandSelectedMinSvg = 'assets/svg/island-selected-min.svg';
static const islandTaskSvg = 'assets/svg/island-task.svg';
static const islandSvg = 'assets/svg/island.svg';
static const jifenSvg = 'assets/svg/jifen.svg';
static const langhuaCoinSvg = 'assets/svg/langhua-coin.svg';
static const lingshiSvg = 'assets/svg/lingshi.svg';
static const locationSvg = 'assets/svg/location.svg';
static const location2Svg = 'assets/svg/location2.svg';
static const logoSvg = 'assets/svg/logo.svg';
static const mallSelectedSvg = 'assets/svg/mall-selected.svg';
static const mallSvg = 'assets/svg/mall.svg';
static const mall2Svg = 'assets/svg/mall2.svg';
static const mapSvg = 'assets/svg/map.svg';
static const mineSelectedSvg = 'assets/svg/mine-selected.svg';
static const mineSvg = 'assets/svg/mine.svg';
static const myInsuranceMinSvg = 'assets/svg/my-insurance-min.svg';
static const orderSelectedSvg = 'assets/svg/order-selected.svg';
static const orderSvg = 'assets/svg/order.svg';
static const packageSvg = 'assets/svg/package.svg';
static const personSvg = 'assets/svg/person.svg';
static const phoneSvg = 'assets/svg/phone.svg';
static const phone2Svg = 'assets/svg/phone2.svg';
static const plainBlueIslandSvg = 'assets/svg/plain-blue-island.svg';
static const plusSvg = 'assets/svg/plus.svg';
static const qrcodeSvg = 'assets/svg/qrcode.svg';
static const quanSvg = 'assets/svg/quan.svg';
static const questionSvg = 'assets/svg/question.svg';
static const rmbSvg = 'assets/svg/rmb.svg';
static const rmb2Svg = 'assets/svg/rmb2.svg';
static const scanSvg = 'assets/svg/scan.svg';
static const searchSvg = 'assets/svg/search.svg';
static const serviceSvg = 'assets/svg/service.svg';
static const settingSvg = 'assets/svg/setting.svg';
static const shareSvg = 'assets/svg/share.svg';
static const shopBagSvg = 'assets/svg/shop-bag.svg';
static const signinSvg = 'assets/svg/signin.svg';
static const tabbarMinSvg = 'assets/svg/tabbar-min.svg';
static const tagSvg = 'assets/svg/tag.svg';
static const teamSvg = 'assets/svg/team.svg';
static const threeArrowSvg = 'assets/svg/three-arrow.svg';
static const truckSvg = 'assets/svg/truck.svg';
static const vSvg = 'assets/svg/v.svg';
static const vipMinSvg = 'assets/svg/vip-min.svg';
static const walletSvg = 'assets/svg/wallet.svg';
static const wallet2Svg = 'assets/svg/wallet2.svg';
static const wechatPaySvg = 'assets/svg/wechat-pay.svg';
static const wechatSvg = 'assets/svg/wechat.svg';
static const welfareSvg = 'assets/svg/welfare.svg';
static const workbenchSvg = 'assets/svg/workbench.svg';
static const xSvg = 'assets/svg/x.svg';
static const yellowIslandSvg = 'assets/svg/yellow-island.svg';
static const yiyuSvg = 'assets/svg/yiyu.svg';
